11111111
10P00EC1
110C1101
11011101
11111111
