111111111111111111111111111111111111111111111111111111111111
1P0C000D1010001111111111111111111111111111111111111111111111
1101010CE000011111111111111111111111111111111111111111111111
1010010000CD0C1111111111111111111111111111111111111111111111
111111111111111111111111111111111111111111111111111111111111