111111111111111111111111
1P0001001C100C0000000011
1000000010101000C0000111
11001C100C00000000111111
1000010010101000C0000111
101000000000000000011111
11001C100C00000000111111
1000010010101000C0000111
101000000000000000011111
10100000000000000E001111
111111111111111111111111
