111111111111111
1P0001001C100C1
10E001001010011
101000000000001
111111111111111
