111111111111111111111111
1P0001001C100C
10E00100101001
10100000000000
111111111111111
