111111111
1P0C0C0C1
10C0C0C01
1C0C0C0E1
111111111