11111111111111111111111111111111
1P0C0000101000111111111111111111
1101010CE00001111111111111111111
1010010000C00C111111111111111111
11111111111111111111111111111111