0111111111
1P00000001
1000001001
1C00E00C01
1111111111