11111111
1P00E001
100010C1
11111111
