11111111
1PE00001
100010C1
11111111
