111111111111111
1P0001001C100C1
11E101000010011
10100CC10000001
111111111111111