111111111111111
1P00010010100C1
11E101000010011
101000C10000001
111111111111111