111111111111111
1P0C000010100E1
1101010C0000011
1010010000C0001
111111111111111