111111111111111111111111
1P0001001C100C0000000011
10E00100101001000C000011
101000000000000000001111
111111111111111111111111
